6 8
011110
112210
153210
113211
112321
143221
144941
111111