0000000000000000
0000000000000000
0000000000000000
0011111000000000
0015221000000000
0012331011100000
0012321014100000
0011121114100000
0001122224100000
0001222122100000
0001222111100000
0001111100000000
0000000000000000
0000000000000000
0000000000000000
0000000000000000