0000000000000000
0000000000000000
0000000000000000
0000111110000000
0000125111000000
0000123221000000
0001112121100000
0001412122100000
0001432212100000
0001422232100000
0001111111100000
0000000000000000
0000000000000000
0000000000000000
0000000000000000
0000000000000000