0000000000000000
0000000000000000
0000000000000000
0000011111100000
0000012222100000
0001113332100000
0001523442100000
0001234441100000
0001111221000000
0000001111000000
0000000000000000
0000000000000000
0000000000000000
0000000000000000
0000000000000000
0000000000000000