0000000000000000
0000000000000000
0000000000000000
0001111111000000
0001222221110000
0011311122210000
0015223223210000
0012441232110000
0011441222100000
0001111111100000
0000000000000000
0000000000000000
0000000000000000
0000000000000000
0000000000000000
0000000000000000