11 9
01111111110
01221122210
01222322210
01321112310
01214441210
11214441211
12322322321
12222212251
11111111111
